1111111111111111
1000000000000001
1000000000000001
1000000000000001
1000001000000001
1000010000000001
1000000000000001
10000000000000N1
1001001000010001
1111111111111111