F      117,      117,117


NO ./images/wall_new.xpm

SO ./images/floor.xpm

WE ./images/perple_stone.xpm

EA         ./images/AnyConv.com__ice.xpm

C      240,240,240



1111111 11111111
1000001 10000001
1000001 10000001
1011111 11111001111111
101         1100000001
101111111111111111111111111111
1000000000S00001
1000000000000001
1111111111110011111
           110010011
           110000111
           1111111 11